# pulled from cfm stack dump --
# useful for deserial class hunting ?? maybe --
# parse as need into --
asSubclass(java.lang.Class) 	java.lang.Class
cast(java.lang.Object)
desiredAssertionStatus() 	boolean
forName(java.lang.String, boolean, java.lang.ClassLoader) 	java.lang.Class
forName(java.lang.Module, java.lang.String) 	java.lang.Class
forName(java.lang.String) 	java.lang.Class
getAnnotatedInterfaces() 	java.lang.reflect.AnnotatedType[]
getAnnotatedSuperclass() 	java.lang.reflect.AnnotatedType
getAnnotation(java.lang.Class) 	java.lang.annotation.Annotation
getAnnotations() 	java.lang.annotation.Annotation[]
getAnnotationsByType(java.lang.Class) 	java.lang.annotation.Annotation[]
getCanonicalName() 	java.lang.String
getClassLoader() 	java.lang.ClassLoader
getClasses() 	java.lang.Class[]
getComponentType() 	java.lang.Class
getConstructor(java.lang.Class[]) 	java.lang.reflect.Constructor
getConstructors() 	java.lang.reflect.Constructor[]
getDeclaredAnnotation(java.lang.Class) 	java.lang.annotation.Annotation
getDeclaredAnnotations() 	java.lang.annotation.Annotation[]
getDeclaredAnnotationsByType(java.lang.Class) 	java.lang.annotation.Annotation[]
getDeclaredClasses() 	java.lang.Class[]
getDeclaredConstructor(java.lang.Class[]) 	java.lang.reflect.Constructor
getDeclaredConstructors() 	java.lang.reflect.Constructor[]
getDeclaredField(java.lang.String) 	java.lang.reflect.Field
getDeclaredFields() 	java.lang.reflect.Field[]
getDeclaredMethod(java.lang.String, java.lang.Class[]) 	java.lang.reflect.Method
getDeclaredMethods() 	java.lang.reflect.Method[]
getDeclaringClass() 	java.lang.Class
getEnclosingClass() 	java.lang.Class
getEnclosingConstructor() 	java.lang.reflect.Constructor
getEnclosingMethod() 	java.lang.reflect.Method
getEnumConstants() 	java.lang.Object[]
getField(java.lang.String) 	java.lang.reflect.Field
getFields() 	java.lang.reflect.Field[]
getGenericInterfaces() 	java.lang.reflect.Type[]
getGenericSuperclass() 	java.lang.reflect.Type
getInterfaces() 	java.lang.Class[]
getMethod(java.lang.String, java.lang.Class[]) 	java.lang.reflect.Method
getMethods() 	java.lang.reflect.Method[]
getModifiers() 	int
getModule() 	java.lang.Module
getName() 	java.lang.String
getNestHost() 	java.lang.Class
getNestMembers() 	java.lang.Class[]
getPackage() 	java.lang.Package
getPackageName() 	java.lang.String
getProtectionDomain() 	java.security.ProtectionDomain
getResource(java.lang.String) 	java.net.URL
getResourceAsStream(java.lang.String) 	java.io.InputStream
getSigners() 	java.lang.Object[]
getSimpleName() 	java.lang.String
getSuperclass() 	java.lang.Class
getTypeName() 	java.lang.String
getTypeParameters() 	java.lang.reflect.TypeVariable[]
isAnnotation() 	boolean
isAnnotationPresent(java.lang.Class) 	boolean
isAnonymousClass() 	boolean
isArray() 	boolean
isAssignableFrom(java.lang.Class) 	boolean
isEnum() 	boolean
isInstance(java.lang.Object) 	boolean
isInterface() 	boolean
isLocalClass() 	boolean
isMemberClass() 	boolean
isNestmateOf(java.lang.Class) 	boolean
isPrimitive() 	boolean
isSynthetic() 	boolean
newInstance() 	java.lang.Object
toGenericString() 	java.lang.String
toString() 	java.lang.String
